###########################################################################
#Copyright 1999 The Internet Dictionary Project/Tyler Chambers
#http://www.june29.com/IDP/
#This file is free to use and modify.  Thank you for using the IDP.
#
#Approximately 5048 entries.  9/21/97
#Approximately 5488 entries.  1/7/98
#Approximately 5910 entries.  3/8/98
#Approximately 7450 entries.  2/19/99
###########################################################################
abolishable	abolible
abolishable	suprimible
abolished	abolido
advertisement	el anuncio
advice	el consejo
buy	comprar
buyer	comprador
byte	el byte[Noun]
bytes	los bytes[Noun]
cab	POLICIA[Noun]
cab	taxi
cab	taxi, radiotaxi
cabal	concilia/bulo[Noun]
cabala	ca/bala
cabalism	cabalismo[Noun]
dress	el vestido
dresses	los vestidos[Noun]
drink	beber
drink	tomar
drink	el refresco[Noun]
drinking glass	el vaso
expressive	expresivo[Adjective]
extending	extendiendo
eye	4280
eye	el ojo
eyebrow	la ceja
eyeglasses	ojos
eyes	los ojos
fable	fabula
fabric	fabrica[Noun]
fabricant	fabricante
fabulist	fabulista[Noun]
fabulous	fabuloso[Adjective]
smoke	fumar
smooth	liso
snack	tomar un aperitivo, picar[Verb]
